0 0 1 p P 0 e 0 p 0
1 0 p p 1 E 1 0 1 0
1 X 1 0 1 E 1 K 0 0
0 0 P 0 p E 0 0 1 p
0 1 1 0 K C 1 0 1 p
0 0 0 0 0 0 p E E p